# 形容            形容う          形動たり        形動            独立語
# 副詞            連体            接続            助数            感動
# 名詞数詞        名詞            名形            名サ            名サ他
# 形動特殊        名詞場所        名詞人          名詞組織        名詞建物
# 数詞特殊        数詞            冠数            接尾人名        接尾形容
# 接尾形動        接尾            接尾サ変        接尾一段        接尾地名
# 接尾連用1       接尾連用2       接尾連用3       接頭            接頭サ
# 接頭形動        接頭地名        接頭人名        接頭お          接頭ご
# 単漢            カ五            カ五いく        カ五ゆく        ガ五
# サ五            タ五            ナ五            バ五            マ五
# ラ五            ラ五ける        ラ五ある        ラ五特殊        ワ五
# ワ五う          一段            カ変            サ変            ザ変
# サ変する        ハ四            地名町名        地名            人姓
# 人名            組織            組織企業        固名商品        固名
# 地名行政区分
#
# $Idaemons: /home/cvs/knu/vje/shogi.vje.txt,v 1.4 2002/01/26 20:14:10 knu Exp $

１１	１一	【名詞】
１２	１二	【名詞】
１３	１三	【名詞】
１４	１四	【名詞】
１５	１五	【名詞】
１６	１六	【名詞】
１７	１七	【名詞】
１８	１八	【名詞】
１９	１九	【名詞】
２１	２一	【名詞】
２２	２二	【名詞】
２３	２三	【名詞】
２４	２四	【名詞】
２５	２五	【名詞】
２６	２六	【名詞】
２７	２七	【名詞】
２８	２八	【名詞】
２９	２九	【名詞】
３１	３一	【名詞】
３２	３二	【名詞】
３３	３三	【名詞】
３４	３四	【名詞】
３５	３五	【名詞】
３６	３六	【名詞】
３７	３七	【名詞】
３８	３八	【名詞】
３９	３九	【名詞】
４１	４一	【名詞】
４２	４二	【名詞】
４３	４三	【名詞】
４４	４四	【名詞】
４５	４五	【名詞】
４６	４六	【名詞】
４７	４七	【名詞】
４８	４八	【名詞】
４９	４九	【名詞】
５１	５一	【名詞】
５２	５二	【名詞】
５３	５三	【名詞】
５４	５四	【名詞】
５５	５五	【名詞】
５６	５六	【名詞】
５７	５七	【名詞】
５８	５八	【名詞】
５９	５九	【名詞】
６１	６一	【名詞】
６２	６二	【名詞】
６３	６三	【名詞】
６４	６四	【名詞】
６５	６五	【名詞】
６６	６六	【名詞】
６７	６七	【名詞】
６８	６八	【名詞】
６９	６九	【名詞】
７１	７一	【名詞】
７２	７二	【名詞】
７３	７三	【名詞】
７４	７四	【名詞】
７５	７五	【名詞】
７６	７六	【名詞】
７７	７七	【名詞】
７８	７八	【名詞】
７９	７九	【名詞】
８１	８一	【名詞】
８２	８二	【名詞】
８３	８三	【名詞】
８４	８四	【名詞】
８５	８五	【名詞】
８５ひ	８五飛	【名詞】
８６	８六	【名詞】
８７	８七	【名詞】
８８	８八	【名詞】
８９	８九	【名詞】
９１	９一	【名詞】
９２	９二	【名詞】
９３	９三	【名詞】
９４	９四	【名詞】
９５	９五	【名詞】
９６	９六	【名詞】
９７	９七	【名詞】
９８	９八	【名詞】
９９	９九	【名詞】
あい	合	【接尾】
あい	相	【接頭】
あいがかり	相掛かり	【名詞】
あいきかず	合利かず	【名詞】
あいこしかけぎん	相腰掛け銀	【名詞】
あいごま	合駒	【名詞】
あいふり	相振り	【名詞】
あいふりびしゃ	相振り飛車	【名詞】
あいやぐら	相矢倉	【名詞】
あがる	上	【接尾】
あくけい	悪形	【名詞】
あそびごま　	遊び駒	【名詞】
あわせふ	合わせ歩	【名詞】
いぎょく	居玉	【名詞】
いしだりゅう	石田流	【名詞】
いちすじ	１筋	【名詞】
いちだんきん	一段金	【名詞】
いっていって	一手一手	【名詞】
いっぷ	一歩	【名詞】
いびあな	居飛穴	【名詞】
いびしゃ	居飛車	【名詞】
いりおう	入王	【名詞】
うきごま	浮き駒	【名詞】
うきびしゃ	浮き飛車	【名詞】
うち	打	【接尾】
うち	打ち	【接尾】
うちふ	打ち歩	【名詞】
えいしゅん	英春	【人名】
おうてびしゃ	王手飛車	【名詞】
おうひ	王飛	【名詞】
おおごま	大駒	【名詞】
かくがわり	角換わり	【名詞】
かくこう	角行	【名詞】
かくすじ	角筋	【名詞】
かくとう	角頭	【名詞】
かくなり	角成	【名詞】
かくみち	角道	【名詞】
かにがこい	カニ囲い	【名詞】
かべぎん	壁銀	【名詞】
かべけい	壁形	【名詞】
からなり	空成り	【名詞】
がこい	囲い	【接尾】
がっちゃんぎん	ガッチャン銀	【名詞】
きかし	利かし	【名詞】
きき	利き	【名詞】
きしゅ	奇手	【名詞】
きしゅ	鬼手	【名詞】
きゅうすじ	９筋	【名詞】
きゅうせん	急戦	【名詞】
きょう	香	【名詞】
きょうしゅ	強手	【名詞】
きょうすじ	香筋	【名詞】
きょうなり	香成	【名詞】
きょうぼう	強防	【名詞】
きんぞこ	金底	【名詞】
きんて	禁手	【名詞】
きんびらき	金開き	【名詞】
きんむそう	金無双	【名詞】
きんやぐら	金矢倉	【名詞】
ぎもんしゅ	疑問手	【名詞】
ぎょくけい	玉形	【名詞】
ぎょくしょう	玉将	【名詞】
ぎょくとう	玉頭	【名詞】
ぎょくひ	玉飛	【名詞】
ぎんかん	銀冠	【名詞】
ぎんかんむり	銀冠	【名詞】
ぎんけい	銀桂	【名詞】
ぎんたちやぐら	銀立ち矢倉	【名詞】
ぎんたでん	銀多伝	【名詞】
ぎんなり	銀成	【名詞】
ぎんみの	銀美濃	【名詞】
ぎんやぐら	銀矢倉	【名詞】
くさりがまぎん	鎖鎌銀	【名詞】
くらいどり	位取り	【名詞】
くらいまけ	位負け	【名詞】
けい	桂	【名詞】
けいきょう	桂香	【名詞】
けいしゅ	軽手	【名詞】
けいぞくしゅ	継続手	【名詞】
けいとう	桂頭	【名詞】
けいなり	桂成	【名詞】
けいみょうしゅ	軽妙手	【名詞】
こうけい	好形	【名詞】
こうしょ	好所	【名詞】
こうだんしゃ	高段者	【名詞】
こうちゃく	好着	【名詞】
こうぼう	好防	【名詞】
こごま	小駒	【名詞】
こしかけぎん	腰掛け銀	【名詞】
こまあまり	駒余り	【名詞】
こまおち	駒落ち	【名詞】
こまおと	駒音	【名詞】
こまぐみ	駒組み	【名詞】
こまぞん	駒損	【名詞】
こまどく	駒得	【名詞】
こまわり	駒割り	【名詞】
ごすじ	５筋	【名詞】
ごて	△	【独立語】
ごて	▽	【独立語】
ごま	駒	【接尾】
さがる	下	【接尾】
さしすぎ	指しすぎ	【名詞】
さんけんびしゃ	三間飛車	【名詞】
さんげんびしゃ	三間飛車	【名詞】
さんすじ	３筋	【名詞】
さんぷ	三歩	【名詞】
しけんびしゃ	四間飛車	【名詞】
しちごま	質駒	【名詞】
しっちゃく	失着	【名詞】
しょうてんのふ	焦点の歩	【名詞】
しょうぶて	勝負手	【名詞】
じしょうぎ	持将棋	【名詞】
じっせんふ	実戦譜	【名詞】
じゅうじびしゃ	十字飛車	【名詞】
すぐ	直	【接尾】
すずめさし	スズメ刺し	【名詞】
せいちゃく	正着	【名詞】
せん	戦	【接尾】
せんけい	戦型	【名詞】
せんご	先後	【名詞】
せんて	▲	【独立語】
せんにちて	千日手	【名詞】
そうやぐら	総矢倉	【名詞】
そこふ	底歩	【名詞】
そでびしゃ	袖飛車	【名詞】
ぞくしゅ	俗手	【名詞】
ぞん	損	【接尾】
たかみの	高美濃	【名詞】
たていしりゅう	立石流	【名詞】
たてぎき	縦利き	【名詞】
たてふどり	縦歩取り	【名詞】
たねごま	種駒	【接尾】
たれふ	垂れ歩	【名詞】
たんてすう	短手数	【名詞】
ちかてつびしゃ	地下鉄飛車	【名詞】
ちゅうあい	中合	【名詞】
ちゅうあい	中合い	【名詞】
ちゅうざびしゃ	中座飛車	【名詞】
ちょうてすう	長手数	【名詞】
つかず	不突	【名詞】
つぎふ	継ぎ歩	【名詞】
つなぎけい	継ぎ桂	【名詞】
つのぎん	ツノ銀	【名詞】
つま	詰ま	【サ五】
つまず	不詰	【名詞】
つみ	詰み	【名詞】
つめよ	詰めよ	【名詞】
つめろ	詰めろ	【名詞】
つるしけい	吊るし桂	【名詞】
つるしづめ	吊るし詰め	【名詞】
づみ	詰み	【接尾】
づめ	詰め	【接尾】
てじゅんぜんご	手順前後	【名詞】
てすき	手スキ	【助数】
てぞん	手損	【名詞】
てどく	手得	【名詞】
てなおり	手直り	【名詞】
てんしゅかくみの	天守閣美濃	【名詞】
とうりょう	投了	【名詞】
ときん	と金	【名詞】
とり	取り	【接尾】
とんし	トン死	【名詞】
どう	同	【接頭】
どうおう	同王	【名詞】
どうかく	同角	【名詞】
どうきょう	同香	【名詞】
どうきん	同金	【名詞】
どうぎょく	同玉	【名詞】
どうぎん	同銀	【名詞】
どうけい	同桂	【名詞】
どうひ	同飛	【名詞】
どうひしゃ	同飛車	【名詞】
どうふ	同歩	【名詞】
どく	得	【接尾】
どり	取り	【接尾】
なかずまい	中住まい	【名詞】
なかはらがこい	中原囲い	【名詞】
なかびしゃ	中飛車	【名詞】
ななすじ	７筋	【名詞】
ならず	不成	【名詞】
なり	成	【接尾】
なりきょう	成香	【名詞】
なりぎん	成銀	【名詞】
なりけい	成桂	【名詞】
にすじ	２筋	【名詞】
にふ	二歩	【名詞】
にゅうぎょく	入玉	【名サ】
はいちゃく	敗着	【名詞】
はしぎょく	端玉	【名詞】
はしぜめ	端攻め	【名詞】
はしふ	端歩	【名詞】
はじぎょく	端玉	【名詞】
はじぜめ	端攻め	【名詞】
はじふ	端歩	【名詞】
はちすじ	８筋	【名詞】
はなれごま	離れ駒	【名詞】
はめて	ハメ手	【名詞】
はめて	嵌め手	【名詞】
はやくりぎん	早繰り銀	【名詞】
はやざし	早指し	【名詞】
はやじかけ	早仕掛け	【名詞】
はらきん	腹金	【名詞】
はらぎん	腹銀	【名詞】
ひ	飛	【名詞】
ひかく	飛角	【名詞】
ひく	引	【接尾】
ひしゃかく	飛車角	【名詞】
ひしゃさき	飛車先	【名詞】
ひしゃすじ	飛車筋	【名詞】
ひしゃなり	飛車成	【名詞】
ひしゃみち	飛車道	【名詞】
ひだりきょう	左香	【名詞】
ひだりきん	左金	【名詞】
ひだりぎん	左銀	【名詞】
ひだりけい	左桂	【名詞】
ひだりみの	左美濃	【名詞】
ひっし	必至	【名詞】
ひなり	飛成	【名詞】
ひねりびしゃ	ヒネリ飛車	【名詞】
びさ	微差	【名詞】
びしゃ	飛車	【接尾】
ふ	歩	【助数】
ふぎれ	歩切れ	【名詞】
ふこしぎん	歩越し銀	【名詞】
ふつき	不突	【名詞】
ふつき	歩突き	【名詞】
ふづめ	不詰	【名詞】
ふづめ	歩詰	【名詞】
ふながこい	舟囲い	【名詞】
ふなり	不成	【名詞】
ふなり	歩成	【名詞】
ふひょう	歩兵	【名詞】
ふりごま	振り駒	【名詞】
ふりびしゃ	振り飛車	【名詞】
ほんぷ	本譜	【名詞】
ぼうきん	棒金	【名詞】
ぼうぎん	棒銀	【名詞】
まいがえ	枚換え	【助数】
みぎきょう	右香	【名詞】
みぎきん	右金	【名詞】
みぎぎょく	右玉	【名詞】
みぎぎん	右銀	【名詞】
みぎけい	右桂	【名詞】
みぎしけん	右四間	【名詞】
みぎしけんびしゃ	右四間飛車	【名詞】
みのがこい	美濃囲い	【名詞】
みょうぼう	妙防	【名詞】
むかいびしゃ	向かい飛車	【名詞】
むすじ	無筋	【名詞】
むりすじ	無理筋	【名詞】
やぐら	矢倉	【名詞】
やり	香	【名詞】
よこぎき	横利き	【名詞】
よこふ	横歩	【名詞】
よこふどり	横歩取り	【名詞】
よづめ	余詰	【名詞】
よねながぎょく	米長玉	【名詞】
より	寄り	【名詞】
よりすじ	寄り筋	【名詞】
よる	寄	【接尾】
よんすじ	４筋	【名詞】
りきせんけい	力戦形	【名詞】
りそうけい	理想形	【名詞】
りゅうおう	龍王	【名詞】
りゅうま	龍馬	【名詞】
りょうおうて	両王手	【名詞】
りょうとり	両取り	【名詞】
りょうどり	両取り	【名詞】
ろくすじ	６筋	【名詞】
わりうち	割り打ち	【名詞】
わりぎん	割り銀	【名詞】
